Achtung = Warning
Mein = My
Tanzstil = Dance
ist = is
notorisch = notoriously
Achtung! Mein Tanzstil ist notorisch. = Attention! My style is notoriously.
Ich = I
bin = am
ein = a
bisschen = bit
grobmotorisch = grobmotorisch
Ich bin ein bisschen grobmotorisch. = I'm a little bit grobmotorisch.
warne = warne
euch = you
mal = time
provisorisch = provisionally
Ich warne euch mal provisorisch: = I warn you once provisionally:
will = wants
tanzen = dance
Achtung! Ich will tanzen! = Attention! I want to dance!
Tanzen = Dance
für = for
mich = me
unentbehrlich = essential
Tanzen ist für mich unentbehrlich, = Dance for me is indispensable,
aber = but
auch = also
nicht = not
ganz = very
ungefährlich = safe
aber auch nicht ganz ungefährlich. = but also quite dangerous.
noch = still
jetzt = now
ehrlich = honest
Ich warne euch noch mal, jetzt ehrlich: = I warn you again, honest now:
Gib = Give
mir = me
den = the
Beat = Beat
gib = give
die = the
Bässe = Bass
Gib mir den Beat, gib mir die Bässe, = Give me the Beat, give me the bass,
Groove = Groove
mitten = in the middle of
in = in
Fresse = Face
gib mir den Groove mitten in die Fresse, = give me the Groove in the middle of the face,
viel = much
Platz = Place
bevor = before
ich's = I's
vergesse = forget
gib mir viel Platz; bevor ich's vergesse: = give me a lot of space
lauf' = run'
beim = when
auf = on
Schnelle = Fast
Ich lauf' beim Tanzen auf die Schnelle = I run' Dancing on the Fast
paar = couple
Sekunden = Seconds
der = the
Stelle = Place
ein paar Sekunden auf der Stelle, = a few seconds on the spot,
dazu = to do this,
La-Ola-Welle = La Ola-Wave
- = -
dazu noch die La-Ola-Welle - = the La-Ola-wave -
Dabei = Here
dreh = rotary
ich = I
im = in the
Kreis = Circle
rum = rum
Dabei dreh ich mich noch im Kreis rum, = This spin me around in circles,
das = the
wirkt = acts
dann = then
endlich = finally
richtig = correct
scheißdumm = scheißdumm
das wirkt dann endlich richtig scheißdumm. = the effect is finally right scheißdumm.
Wenn = If
einer = a
lacht = laughs
sag' = tell'
Sei's = Sei's
drum = drum
Wenn einer lacht, sag' ich mir "Sei's drum!" = If one laughs, I say to myself, "so Be it!"
Gib mir den Beat, gib mir die Bässe = Give me the Beat, give me the bass
Jetzt = Now
gibt's = there's
was = what
Glocke = Bell
Jetzt gibt's noch mal was auf die Glocke. = Now, there's still something on the bell.
Bevor = Before
final = final
abrocke = abrocke
Bevor ich dann final abrocke, = Before I then final abrocke,
gehen = go
wir = we
alle = all
Hocke = Squat
gehen wir alle in die Hocke. = we all go into the squat.
Arme = Arms
verschränkt = entangled
und = and
Kopp = Kopp
in'n = in'n
Nacken = Neck
Arme verschränkt und Kopp in'n Nacken: = Arms crossed and Kopp in'n neck:
Wir = We
wie = as
Don = Don
Kosaken = Cossacks
Wir tanzen wie die Don Kosaken. = We dance like the Don Cossacks.
Hört = Listen
ihr = your
es = it
schon = already
Rücken = Back
knacken = crack
Hört ihr es schon im Rücken knacken? = Do you listen to it already in the back crack?
hab = 've
Euch = You
frohe = merry
Kunde = Customer
Ich hab für Euch die frohe Kunde: = I have for you, the good news:
drehen = rotate
'ne = 'ne
Ehrenrunde = Victory lap
Wir drehen jetzt 'ne Ehrenrunde = We turn now a lap of honour
ne = ne
halbe = half
Stunde = Hour
und tanzen noch ne halbe Stunde. = and dancing is still half an hour.
Ihr = Your
werdet = will
morgen = morning
dafür = for
büßen = atone
Ihr werdet morgen dafür büßen: = You will tomorrow pay for:
wach = awake
mit = with
dicken = thick
Füßen = Feet
Ihr werdet wach mit dicken Füßen. = You will awake with thick feet.
Die = The
könnt = you can
von = of
schön = nice
grüßen = greet
Die könnt ihr dann von mir schön grüßen. = Which you can then from beautiful to me sincerely.
