the = die
of = von
and = und
to = zu
a = ein
in = in
you = Sie
for = für
or = oder
it = es
as = als
be = werden
on = auf
with = mit
can = kann
have = haben
this = diese
by = von
not = nicht
but = aber
at = an
from = von
I = Ich
they = Sie
more = mehr
will = wird
if = wenn
some = einige
there = es
what = was
about = über
which = die
when = wenn
one = eine
all = alle
also = auch
how = wie
many = viele
do = tun
most = die meisten
people = Menschen
other = andere
time = Zeit
so = so
we = wir
may = Mai
like = wie
use = Nutzung
into = in
than = als
up = bis
out = aus
who = wer
make = machen
because = da
such = so
through = durch
get = bekommen
work = Arbeit
even = auch
no = keine
new = neue
film = film
just = nur
only = nur
see = sehen
good = gut
water = Wasser
need = müssen
should = sollte
very = sehr
any = alle
history = Geschichte
often = oft
way = Weg
well = gut
art = Kunst
know = weiß
then = dann
first = erste
would = würde
money = Geld
each = jeder
over = über
world = Welt
map = Karte
find = suchen
where = wo
much = viel
take = nehmen
two = zwei
want = wollen
important = wichtig
family = Familie
example = Beispiel
while = während
he = er
look = suchen
before = vor
help = Hilfe
between = zwischen
go = gehen
own = eigenen
however = jedoch
business = business
great = große
another = ein anderes
health = Gesundheit
same = gleichen
study = Studie
why = warum
few = paar
game = Spiel
might = vielleicht
think = denken
free = frei
too = zu
right = Recht
still = noch
system = system
after = nach
best = beste
must = muss
life = Leben
since = da
could = könnte
now = jetzt
during = während
learn = lernen
around = rund
form = form
meat = Fleisch
air = air
day = Tag
place = Platz
become = werden
number = Anzahl
public = öffentlich
read = Lesen
keep = halten
part = Teil
start = start
year = Jahr
every = jeder
field = Feld
large = große
once = einmal
available = verfügbar
down = nach unten
give = geben
fish = Fisch
human = Mensch
both = beide
local = lokale
sure = sicher
without = ohne
come = kommen
back = zurück
general = allgemein
process = Vorgang
she = Sie
heat = Wärme
specific = spezifische
enough = genug
long = lang
lot = Menge
hand = hand
popular = beliebt
small = kleine
though = obwohl
experience = Erfahrung
include = enthalten
job = job
music = Musik
person = person
really = wirklich
although = obwohl
thank = danke
book = Buch
early = früh
end = Ende
method = Methode
never = nie
less = weniger
play = Spiel
able = Lage
data = Daten
feel = fühlen
high = hoch
off = off
point = Punkt
type = Typ
whether = ob
food = Essen
here = hier
home = Heim
certain = bestimmte
economy = Wirtschaft
little = wenig
theory = Theorie
tonight = heute Abend
law = Gesetz
put = stellen
under = unter
value = Wert
always = immer
body = Körper
common = gemeinsame
market = Markt
set = set
bird = Vogel
guide = Anleitung
provide = bieten
change = ändern
interest = Zinsen
literature = Literatur
problem = problem
say = sagen
next = weiter
create = erstellen
simple = einfach
software = software
state = Zustand
together = zusammen
control = Steuerung
knowledge = wissen
power = Leistung
radio = radio
course = natürlich
hard = schwer
add = hinzufügen
company = Unternehmen
love = Liebe
past = Vergangenheit
price = Preis
size = Größe
away = Weg
big = große
internet = internet
possible = möglich
television = Fernsehen
three = drei
understand = verstehen
various = verschiedene
card = Karte
difficult = schwierig
list = Liste
mind = Geist
particular = insbesondere
real = real
science = Wissenschaft
trade = Handel
consider = prüfen
either = entweder
library = Bibliothek
likely = wahrscheinlich
nature = Natur
fact = Tatsache
line = line
product = Produkt
care = Pflege
group = Gruppe
idea = Idee
risk = Risiko
several = mehrere
temperature = Temperatur
word = Wort
fat = Fett
force = Kraft
key = Schlüssel
light = Licht
today = heute
until = bis
major = große
name = name
school = Schule
top = top
current = aktuelle
left = Links
amount = Menge
level = Ebene
order = Bestellung
practice = Praxis
research = Forschung
sense = Sinn
service = service
area = Bereich
cut = Schnitt
hot = hot
instead = statt
physical = körperliche
piece = Stück
show = Karte
society = Gesellschaft
try = versuchen
check = prüfen
choose = wählen Sie
develop = Entwicklung
second = zweite
tense = angespannt
web = web
boss = boss
short = kurz
story = Geschichte
call = Anruf
industry = Industrie
last = letzter
media = Medien
mental = geistige
move = bewegen
pay = bezahlen
sport = sport
thing = was
against = gegen
far = weit
fun = Spaß
house = Haus
let = lassen
page = Seite
remember = erinnern
term = Begriff
test = test
within = innerhalb
along = zusammen
answer = Antwort
increase = vergrößern
oven = Backofen
quite = ganz
single = Einzel
sound = sound
again = wieder
community = Gemeinschaft
focus = Fokus
individual = individuelle
matter = egal
percent = Prozent
turn = drehen
kind = Art
quality = Qualität
soil = Boden
ask = Fragen
board = Vorstand
buy = kaufen
guard = guard
hold = halten
language = Sprache
main = main
offer = bieten
oil = öl
picture = Bild
potential = Potenzial
professional = professional
rather = eher
access = Zugang
almost = fast
garden = Garten
international = international
open = öffnen
range = Bereich
rate = rate
reason = Grund
travel = Reisen
variety = Vielfalt
video = video
week = Woche
above = oben
according = nach
cook = Kochen
determine = bestimmen
future = Zukunft
site = Standort
alternative = alternative
demand = Nachfrage
ever = je
exercise = übung
image = Bild
special = besonderes
case = Fall
cause = Ursache
coast = Küste
TRUE = WAHR
whole = insgesamt
age = Alter
among = unter
bad = schlecht
boat = Boot
country = Land
dance = Tanz
exam = Prüfung
excuse = Entschuldigung
grow = wachsen
movie = Film
record = Datensatz
result = Ergebnis
section = Abschnitt
across = über
already = bereits
below = unten
mouse = Maus
allow = erlauben
cash = cash
class = Klasse
clear = klar
dry = trocken
easy = einfach
live = live
period = Zeitraum
physics = Physik
plan = plan
store = Shop
tax = Steuer
cold = kalt
full = voll
low = low
old = Alter
policy = Politik
purchase = Kauf
series = Serie
side = Seite
subject = Thema
supply = Lieferung
therefore = daher
basis = Grundlage
boyfriend = Freund
deal = Angebot
direction = Richtung
mean = Mittelwert
primary = primäre
space = Platz
strategy = Strategie
technology = Technologie
worth = Wert
army = Armee
camera = Kamera
fall = fallen
paper = Papier
rule = Regel
similar = ähnlich
stock = Lager
weather = Wetter
yet = noch
bring = bringen
chance = chance
environment = Umgebung
figure = Abbildung
improve = verbessern
man = Mann
mathematics = Mathematik
model = Modell
necessary = notwendig
positive = positiv
produce = produzieren
search = Suche
source = Quelle
child = Kind
earth = Erde
else = sonst
instance = Beispiel
maintain = pflegen
month = Monat
present = vorhanden
program = Programm
spend = verbringen
talk = sprechen
upset = verärgert
begin = beginnen
chicken = Huhn
close = schließen
design = design
feature = feature
head = Kopf
material = material
medical = medizinische
purpose = Zweck
question = Frage
rock = rock
salt = Salz
tell = sagen
university = Universität
act = handeln
article = Artikel
birth = Geburt
car = Auto
cost = Kosten
department = Abteilung
difference = Unterschied
dog = Hund
drive = Laufwerk
essential = wesentliche
exist = vorhanden
federal = Bund
goal = Ziel
green = grün
intelligence = Intelligenz
late = spät
news = news
object = Objekt
scale = Maßstab
sun = Sonne
support = Unterstützung
tend = neigen
thus = so
audience = Zielgruppe
enjoy = genießen
entire = gesamte
fit = Sitz
glad = froh
income = Einkommen
note = Hinweis
perform = ausführen
profit = Gewinn
proper = richtige
remove = entfernen
rent = mieten
return = zurück
run = Ausführung
speed = Geschwindigkeit
strong = starke
style = Stil
war = Krieg
actual = tatsächliche
appropriate = angemessen
bank = bank
complex = Komplex
content = Inhalt
craft = Handwerk
due = aufgrund
failure = Ausfall
half = die Hälfte
inside = innen
meaning = Bedeutung
medicine = Medizin
middle = Mitte
philosophy = Philosophie
regular = regelmäßig
reserve = reservieren
standard = standard
bus = bus
decide = entscheiden
exchange = exchange
eye = Auge
fast = schnell
fire = Feuer
identify = identifizieren
independent = unabhängig
leave = verlassen
original = original
position = position
pressure = Druck
reach = Reichweite
rest = rest
serve = dienen
stress = stress
watch = Uhr
wide = Breite
advantage = Vorteil
benefit = nutzen
box = box
charge = berechnen
complete = vollständig
continue = weiter
frame = Rahmen
issue = Ausgabe
night = Nacht
protect = schützen
require = erforderlich
significant = signifikante
step = Schritt
unless = es sei denn,
active = aktive
break = Pause
chemistry = Chemie
cycle = Zyklus
disease = Krankheit
energy = Energie
face = Gesicht
item = Artikel
metal = Metall
nation = nation
negative = negativ
occur = auftreten
paint = Farbe
pregnant = Schwanger
review = Bewertung
road = Straße
role = Rolle
room = Zimmer
safe = sicher
screen = Bildschirm
soup = Suppe
stay = Aufenthalt
structure = Struktur
view = anzeigen
visit = besuchen Sie
visual = visual
write = schreiben
wrong = falsch
account = Konto
affect = beeinflussen
ago = vor
approach = Ansatz
avoid = vermeiden
ball = ball
behind = hinter
cover = Abdeckung
discipline = Disziplin
medium = Mittel
prepare = Vorbereitung
quick = schnell
ready = fertig
report = Bericht
rise = Aufstieg
share = teilen
apartment = Wohnung
balance = Gleichgewicht
bit = bit
black = schwarz
bottom = unten
build = bauen
choice = Wahl
gift = Geschenk
impact = Auswirkungen
machine = Maschine
moment = moment
shape = Form
straight = gerade
tool = Werkzeug
walk = Spaziergang
white = weiß
wind = wind
achieve = erreichen
address = Adresse
average = Durchschnitt
believe = glauben
beyond = über
career = Karriere
culture = Kultur
decision = Entscheidung
direct = direkte
event = Veranstaltung
excellent = ausgezeichnet
extra = extra
junior = junior
morning = morgen
pick = pick
poor = schlecht
pot = Topf
pretty = ziemlich
property = Eigenschaft
receive = erhalten
seem = scheinen
sign = anmelden
student = Schüler
table = Tabelle
task = Aufgabe
unique = einzigartig
wood = Holz
classic = classic
competition = Wettbewerb
condition = Zustand
contact = Kontakt
credit = Kredit
discuss = diskutieren
egg = ei
final = final
happy = glücklich
hope = Hoffnung
ice = Eis
lift = Aufzug
mix = mix
network = Netzwerk
north = nördlich
office = office
overall = insgesamt
population = Bevölkerung
president = Präsident
private = private
realize = erkennen
responsible = verantwortlich
separate = separate
square = Platz
stop = stoppen
teach = lehren
unit = Einheit
western = western
yes = ja
alone = allein
attempt = Versuch
category = Kategorie
cigarette = Zigarette
concern = Anliegen
contain = enthalten
context = Rahmen
cute = Niedlich
date = Datum
effect = Wirkung
familiar = vertraut
fly = Fliegen
follow = Folgen
link = link
official = offizielle
opportunity = Gelegenheit
perfect = perfekt
post = post
recent = jüngsten
refer = siehe
solve = lösen
star = star
toward = Richtung
voice = Stimme
bright = hell
broad = Breite
capital = Hauptstadt
challenge = Herausforderung
describe = beschreiben
despite = trotz
flat = Wohnung
flight = Flug
friend = Freund
gain = erlangen
length = Länge
magazine = Magazin
maybe = vielleicht
newspaper = Zeitung
nice = schön
prefer = lieber
prevent = verhindern
rich = Reich
save = speichern
self = selbst
soon = bald
stand = stand
warm = warm
young = junge
ahead = vor
beauty = Schönheit
brush = Pinsel
cell = Zelle
couple = paar
debate = Debatte
discover = entdecken
ensure = Gewährleistung
exit = beenden
expect = erwarten
fail = fail
front = vor
function = Funktion
heavy = schwer
invest = investieren
lack = Mangel
lake = See
lead = führen
listen = hören
member = Mitglied
message = Nachricht
plant = pflanze
plastic = Kunststoff
reduce = reduzieren
scene = Szene
serious = ernst
speak = sprechen
spot = Ort
summer = Sommer
taste = Geschmack
theme = Thema
track = track
wing = Flügel
worry = sorgen
appear = erscheinen
brain = Gehirn
button = Taste
click = klicken Sie auf
concept = Konzept
correct = richtig
customer = Kunden
death = Tod
desire = Wunsch
explain = erklären
explore = erkunden
express = express
foot = Fuß
gas = gas
handle = Griff
huge = große
influence = Einfluss
involve = beinhalten
lose = verlieren
meet = treffen
mood = Stimmung
notice = Hinweis
rain = Regen
rare = selten
release = release
sell = verkaufen
slow = langsam
technical = technische
typical = typisch
upon = nach
wall = Wand
woman = Frau
advice = Beratung
afford = leisten
agree = Stimmen
base = base
blood = Blut
clean = sauber
damage = Schaden
distance = Entfernung
effort = Aufwand
electronic = elektronische
finish = fertig
fresh = frisch
hear = hören
immediate = sofort
importance = Bedeutung
normal = normal
opinion = Meinung
otherwise = sonst
pair = pair
plus = plus
press = drücken
remain = bleiben
represent = stellen
ride = Reiten
secret = Geheimnis
skill = Geschicklichkeit
spread = Verbreitung
spring = Frühjahr
staff = Mitarbeiter
sugar = Zucker
target = Ziel
text = text
tough = hart
wait = warten
wealth = Reichtum
animal = Tier
apply = anwenden
author = Autor
aware = bewusst
brown = Braun
budget = budget
cheap = Billig
city = Stadt
county = Grafschaft
deep = tief
discount = Rabatt
display = Anzeige
estate = Immobilien
file = Datei
flow = flow
forget = vergessen
foundation = Stiftung
global = global
ground = Boden
heart = Herz
hit = Treffer
legal = rechtliche
lesson = Lektion
measure = Messen
minute = minute
near = in der Nähe von
objective = Ziel
perspective = Perspektive
phase = phase
promote = Förderung
recipe = Rezept
recommend = empfehlen
register = registrieren
relevant = relevant
rely = verlassen
secure = sicher
shoot = Schießen
sky = sky
stage = Bühne
stick = stick
studio = studio
thin = Dünn
title = Titel
topic = Thema
touch = touch
trouble = ärger
vary = variieren
absolute = absolute
accurate = genaue
bowl = Schüssel
bridge = Brücke
campaign = Kampagne
cancel = Abbrechen
capable = fähig
character = Charakter
chemical = Chemische
club = club
cool = cool
cry = Weinen
dump = dump
edge = edge
evidence = Hinweise
extreme = extreme
fan = fan
generate = generieren
letter = Brief
lock = sperren
maximum = maximale
novel = Roman
obtain = erhalten
option = option
pack = pack
park = park
passion = Leidenschaft
plenty = viel
push = push
quarter = Quartal
resource = Ressource
select = wählen Sie
skin = Haut
sort = Sortieren
accept = akzeptieren
baby = baby
background = hintergrund
carry = tragen
college = college
communicate = kommunizieren
complain = beschweren
conflict = Konflikt
criticism = Kritik
debt = Schulden
define = definieren
depend = abhängen
die = sterben
dish = Gericht
eat = Essen
efficient = effiziente
enter = geben Sie
exact = genaue
factor = Faktor
fair = Messe
fill = füllen
fine = fein
formal = formale
forward = vorwärts
fruit = Obst
glass = Glas
happen = passieren
indicate = zeigen
joint = gemeinsame
jump = springen
kick = kick
master = master
memory = Speicher
muscle = Muskel
opposite = gegenüber
pass = pass
pitch = Spielfeld
red = rot
remote = Fernbedienung
secretary = Sekretär
solution = Lösung
somewhat = etwas
strength = Stärke
suggest = empfehlen
survive = überleben
total = insgesamt
traffic = Verkehr
treat = Behandlung
trip = Reise
vast = große
vegetable = Gemüse
abuse = Missbrauch
administration = Verwaltung
appeal = Beschwerde
appreciate = schätzen
aspect = Aspekt
attitude = Haltung
beat = beat
burn = brennen
chart = Diagramm
compare = vergleichen
deposit = Kaution
foreign = außen
gear = Getriebe
ideal = ideal
imagine = vorstellen
kitchen = Küche
land = land
log = melden
manage = verwalten
mother = Mutter
net = net
party = party
personality = Persönlichkeit
photograph = Foto
practical = praktische
principle = Prinzip
print = drucken
psychology = Psychologie
raise = erhöhen
relative = relative
response = Antwort
sale = Verkauf
season = Saison
severe = schwere
signal = signal
sleep = schlafen
smooth = glatt
spirit = Geist
street = Straße
tree = Baum
version = version
wave = Welle
advance = Voraus
alcohol = Alkohol
belt = Gürtel
bench = Bank
commission = Kommission
connect = schließen
consist = bestehen
contract = Vertrag
contribute = Beitrag
copy = kopieren
dark = dunkel
differ = Verschieden
double = Doppelzimmer
draw = Unentschieden
drop = Tropfen
emphasis = Schwerpunkt
encourage = ermutigen
equal = gleich
expand = erweitern
firm = Firma
fix = fix
frequent = häufige
hire = mieten
internal = interne
join = mitmachen
kill = töten
loss = Verlust
mere = bloße
minimum = minimum
numerous = zahlreiche
path = Pfad
progress = Fortschritt
project = Projekt
prove = beweisen
react = reagieren
recognize = erkennen
relax = entspannen
replace = ersetzen
sea = Meer
sensitive = empfindlich
sit = sitzen
south = Süden
status = status
steak = steak
stuff = Zeug
sufficient = ausreichend
tap = Tippen Sie auf
ticket = ticket
tour = tour
union = union
win = gewinnen
angle = Winkel
attack = Angriff
blue = blau
borrow = leihen
breakfast = Frühstück
cancer = Krebs
claim = Anspruch
confidence = Vertrauen
consistent = Einklang
constant = Konstante
currency = Währung
daughter = Tochter
degree = Grad
doctor = Arzt
dot = dot
drag = ziehen
dream = Traum
drink = trinken
duty = Pflicht
earn = verdienen
enable = aktivieren
essay = Aufsatz
famous = berühmt
father = Vater
fee = Gebühr
finance = Finanzen
guess = denke
hour = Stunde
juice = Saft
limit = limit
luck = Glück
milk = Milch
minor = minor
mixture = Mischung
mouth = Mund
nor = noch
operate = Betrieb
peace = Frieden
pipe = Rohr
please = bitte
previous = Vorherige
pull = ziehen
pure = reiner
raw = raw
reflect = reflektieren
region = region
republic = Republik
seat = Sitz
send = senden
soft = weich
solid = solide
stable = stabil
storm = Sturm
substance = Stoff
team = team
tradition = tradition
trick = trick
virus = virus
wear = tragen
weird = komisch
wonder = Wunder
afraid = Angst
afternoon = Nachmittag
analyze = analysieren
annual = jährlich
anticipate = rechnen
assume = übernehmen
bat = Fledermaus
beach = Strand
blank = leer
busy = gebucht
catch = fangen
chain = Kette
count = Anzahl
cream = Sahne
crew = Mannschaft
dead = tot
detail = detail
device = Gerät
doubt = Zweifel
drama = drama
engage = engagieren
engine = Motor
enhance = verbessern
examine = prüfen
expense = Kosten
FALSE = FALSCH
feed = feed
forever = für immer
gold = gold
hotel = hotel
impress = beeindrucken
install = installieren
interact = interagieren
interview = interview
kid = kid
logic = Logik
mark = mark
match = Spiel
mission = mission
obvious = offensichtlich
pain = Schmerzen
participate = teilnehmen
pleasure = Vergnügen
priority = Priorität
repeat = wiederholen
round = Runde
score = Partitur
screw = Schraube
seek = suchen
sex = Geschlecht
sharp = sharp
shop = shop
shower = Dusche
sing = singen
slide = Folie
strip = Streifen
suit = Anzug
thick = Dicke
tone = Ton
whereas = in der Erwägung, dass
window = Fenster
wise = klug
wish = wünschen
agent = agent
anxiety = Angst
atmosphere = Atmosphäre
band = band
bath = Badewanne
block = block
bone = Knochen
bread = Brot
calendar = Kalender
candidate = Kandidaten
cap = Kappe
climate = Klima
coat = Mantel
collect = sammeln
combine = kombinieren
command = Befehl
contest = Wettbewerb
corner = Ecke
court = Gericht
cup = Tasse
dig = Graben
district = Bezirk
divide = teilen
door = Tür
east = Osten
electric = Elektro
emotion = emotion
equivalent = entspricht
except = außer
finger = finger
garage = garage
guarantee = Garantie
guest = Gast
hang = hängen
height = Höhe
hole = Loch
hook = Haken
hunt = Jagd
implement = Umsetzung
initial = erste
intend = wollen
introduce = Einführung
latter = letztere
layer = layer
lecture = Vortrag
lie = liegen
mall = mall
manner = Weise
march = März
mention = schweigen
narrow = schmal
neither = weder
nose = Nase
partner = partner
profile = Profil
proud = stolz
respect = Achtung
rice = Reis
routine = routine
sample = Beispiel
schedule = Zeitplan
settle = begleichen
smell = Geruch
survey = Umfrage
telephone = Telefon
tie = Krawatte
tip = Tipp
wild = wild
winter = winter
adult = Erwachsene
aggressive = aggressiv
airline = Fluggesellschaft
apart = neben
assure = versichern
attract = gewinnen
bag = Tasche
battle = Kampf
bed = Bett
bill = Rechnung
boring = langweilig
bother = die Mühe
brief = kurze
cake = Kuchen
charity = Nächstenliebe
code = code
commerce = commerce
cousin = Vetter
crazy = verrückt
curve = Kurve
dimension = dimension
disaster = Katastrophe
distinct = verschiedene
distribute = verteilen
dress = Kleid
ease = Leichtigkeit
eastern = Ost
emergency = Notfall
escape = Flucht
evening = Abend
expose = aussetzen
extension = Erweiterung
extent = Umfang
farm = Bauernhof
feedback = feedback
fight = Kampf
gap = Lücke
gather = sammeln
gentle = sanft
govern = Regeln
grade = Grad
guitar = Gitarre
hate = hasse
holiday = Urlaub
homework = Hausaufgaben
horror = horror
horse = Pferd
host = host
husband = Mann
loan = Darlehen
mistake = Fehler
mountain = Berg
nail = Nagel
noise = Lärm
none = keine
occasion = Anlass
outcome = Ergebnis
overcome = überwinden
owe = Schulden
patient = Patienten
pause = pause
phrase = Satz
prior = vor
proof = Beweis
race = Rennen
relief = Erleichterung
repair = Reparatur
resolution = Auflösung
revenue = Umsatz
rough = rau
sad = traurig
sand = sand
scratch = Kratzer
sentence = Satz
session = Sitzung
shoulder = Schulter
sick = krank
smoke = Rauch
stomach = Magen
strange = seltsam
strict = strengen
strike = Streik
string = string
succeed = Erfolg
suffer = leiden
tennis = tennis
throw = werfen
towel = Handtuch
vacation = Ferien
virtual = virtuelle
west = west
wheel = Rad
wine = Wein
acquire = erwerben
adapt = anpassen
adjust = anpassen
administrative = administrative
altogether = insgesamt
argue = argumentieren
arise = entstehen
arm = arm
aside = beiseite
assign = zuweisen
associate = associate
automatic = Automatik
basket = Korb
bet = Wette
blow = Schlag
bonus = bonus
border = Grenze
branch = Zweig
breast = Brust
brother = Bruder
buddy = buddy
bunch = Haufen
cabinet = Schrank
chip = chip
church = Kirche
civil = Zivil
coach = Trainer
coffee = Kaffee
confirm = bestätigen
construct = konstruieren
cross = Kreuz
danger = Gefahr
definite = bestimmte
dinner = Abendessen
document = Dokument
draft = Entwurf
dust = Staub
edit = Bearbeiten
employ = beschäftigen
expert = Experte
external = externe
floor = Boden
former = ehemalige
god = Gott
golf = golf
habit = Gewohnheit
hair = Haar
hardly = kaum
hurt = verletzt
incorporate = integrieren
iron = Eisen
judge = Richter
justify = rechtfertigen
knife = Messer
laboratory = Labor
landscape = Landschaft
laugh = lachen
lay = lag
league = Liga
loud = laut
mail = E-mail
massive = massive
mess = Durcheinander
mobile = mobile
mode = Modus
mud = Schlamm
nasty = böse
native = native
orange = orange
ordinary = gewöhnliche
organize = organisieren
ought = sollte
parent = Eltern
pattern = Muster
pin = pin
police = Polizei
pool = pool
possess = besitzen
pound = Pfund
queen = Königin
ratio = Verhältnis
relation = Bezug
relieve = entlasten
request = Anfrage
respond = Antworten
restaurant = restaurant
retain = behalten
royal = royal
salary = Gehalt
sector = Sektor
senior = senior
shame = Schande
shelter = Schutz
shoe = Schuh
shut = geschlossen
signature = Unterschrift
silver = Silber
song = song
southern = Süden
split = split
strain = Belastung
struggle = Kampf
super = super
swim = schwimmen
tackle = Bekämpfung
tank = tank
tight = engen
tooth = zahn
town = Stadt
train = Zug
trust = Vertrauen
upper = Obere
vehicle = Fahrzeug
visible = sichtbar
volume = Lautstärke
wash = waschen
waste = Abfälle
wife = Frau
yellow = gelb
accident = Unfall
advertise = Werbung
airport = Flughafen
alive = lebendig
angry = wütend
assist = unterstützen
bake = Backen
bar = bar
baseball = baseball
bell = bell
bike = bike
blame = Schuld
boy = junge
brick = Ziegel
calculate = berechnen
chair = Stuhl
chapter = Kapitel
closet = Schrank
clue = Hinweis
collar = Kragen
comment = Kommentar
committee = Ausschuss
compete = Wettbewerb
confuse = verwirren
consult = konsultieren
convert = konvertieren
crash = Absturz
database = Datenbank
deliver = liefern
desperate = verzweifelt
devil = devil
diet = Ernährung
disc = disc
educate = erziehen
enthusiasm = Begeisterung
error = Fehler
extend = erweitern
fear = Angst
fold = Fach
forth = weiter
fuel = Kraftstoff
gate = Tor
girl = Mädchen
glove = Handschuh
grab = greifen
gross = grob
hall = Halle
hide = ausblenden
hospital = Krankenhaus
ill = krank
insure = versichern
investigate = untersuchen
jacket = Jacke
literal = wörtliche
lunch = Mittagessen
meal = Mahlzeit
miss = miss
monitor = monitor
mortgage = Hypothek
negotiate = verhandeln
nurse = Krankenschwester
pace = Tempo
panic = Panik
peak = peak
perception = Wahrnehmung
permit = Genehmigung
pie = pie
plane = Flugzeug
poem = Gedicht
presence = Präsenz
qualify = qualifizieren
quote = Zitat
reception = Rezeption
recover = erholen
resolve = beheben
retire = Ruhestand
revolution = revolution
reward = Belohnung
rid = entfernen
river = Fluss
roll = roll
row = Zeile
sandwich = sandwich
satisfy = befriedigen
scare = erschrecken
shock = Schock
sink = Waschbecken
slip = slip
son = Sohn
sorry = sorry
spare = Ersatzteile
speech = Sprache
spite = trotz
spray = spray
surprise = überraschung
suspect = vermuten
sweet = süß
swing = swing
tea = Tee
transition = übergang
transport = transport
twist = twist
ugly = hässlich
ultimate = ultimate
usual = üblich
village = Dorf
weigh = Wiegen
welcome = willkommen
yard = Hof
abroad = Ausland
alarm = alarm
anxious = ängstlich
apology = Entschuldigung
arrive = Ankunft
attach = befestigen
behave = Verhalten
bend = biegen
bicycle = Fahrrad
bite = Biss
blind = blind
bottle = Flasche
brave = mutig
breath = Atem
cable = Kabel
calm = ruhig
candle = Kerze
celebrate = Feiern
chest = Brust
chocolate = Schokolade
clerk = Schreiber
cloud = cloud
comprehensive = umfassende
concentrate = konzentrieren
concert = Konzert
conclusion = Fazit
convince = überzeugen
cookie = cookie
counter = Zähler
courage = Mut
critic = Kritiker
curious = neugierig
dad = Papa
desk = Schreibtisch
dirty = dirty
downtown = Innenstadt
drawer = Schublade
elevate = erheben
entertain = unterhalten
establish = etablieren
estimate = Schätzung
excite = excite
flower = Blume
garbage = Müll
grand = grand
grocery = Lebensmittelgeschäft
harm = Schaden
honest = ehrlich
honey = Honig
imply = bedeuten
informal = informelle
injure = verletzen
insect = Insekten
insist = bestehen
inspect = prüfen
king = König
knee = Knie
ladder = Leiter
leather = Leder
load = laden
loose = lose
male = Männlich
menu = Menü
mirror = Spiegel
moreover = außerdem
neck = Hals
okay = okay
penalty = Strafe
pension = pension
piano = Klavier
plate = Platte
potato = Kartoffel
proceed = gehen
profession = Beruf
professor = professor
prompt = prompt
purple = lila
pursue = verfolgen
quantity = Menge
quiet = ruhig
refuse = verweigern
regret = bedauern
reveal = zeigen
ruin = Ruine
rush = rush
salad = Salat
shake = schütteln
shift = shift
shine = Glanz
ship = Schiff
sister = Schwester
skirt = Rock
slice = Scheibe
snow = Schnee
specify = angeben
stairs = Treppen
steal = stehlen
stroke = Schlaganfall
suck = saugen
sudden = plötzlich
supermarket = Supermarkt
surround = surround
switch = wechseln
terrible = schrecklich
tire = Reifen
tongue = Zunge
trash = trash
tune = tune
warn = warnen
weak = schwach
zone = zone
accuse = beschuldigen
admire = bewundern
admit = zugeben
adopt = erlässt
affair = Affäre
amaze = überraschen
ambition = Ehrgeiz
anger = Wut
announce = ankündigen
apple = apple
approve = genehmigen
asleep = schlafen
attend = besuchen
award = Preis
bathroom = Badezimmer
bear = Bären
beer = Bier
belong = gehören
bid = Gebot
bitter = bitter
boot = boot
brilliant = brilliant
bug = bug
camp = Lager
candy = candy
carpet = Teppich
cat = Katze
champion = champion
channel = Kanal
cheek = Wange
client = client
clock = Uhr
closes = geschlossen
comfort = Komfort
commit = Begehen
complaints = Beschwerden
compute = berechnen
conscious = bewusst
consequence = Folge
cow = Kuh
crack = crack
criticize = kritisieren
dare = Wagen
dear = Liebe
decent = anständig
delay = Verzögerung
deliberate = bewusste
departure = Abreise
deserve = verdienen
destroy = zerstören
diamond = Diamant
ear = Ohr
embarrass = Verlegenheit
empty = leer
eventual = eventuelle
fault = Fehler
female = weiblich
fortune = Glück
funeral = Beerdigung
gene = gen
girlfriend = Freundin
grass = gras
guilty = schuldig
guy = Kerl
hat = Hut
hell = Hölle
hesitate = zögern
highlight = markieren
hunger = hunger
hurry = beeilen
illustrate = veranschaulichen
incident = Vorfall
inevitable = unvermeidlich
inform = informieren
initiate = initiieren
intent = Absicht
invite = laden
island = Insel
joke = Witz
jury = jury
kiss = Kuss
lady = lady
leg = Bein
lip = Lippe
locate = suchen
lone = lone
mad = mad
manufacture = Herstellung
marry = heiraten
mate = mate
motor = motor
neat = ordentlich
nerve = Nerven
nervous = nervös
odd = seltsam
passage = Durchgang
passenger = PKW
pen = Stift
persuade = überzeugen
pizza = pizza
platform = Plattform
poet = dichter
pop = pop
pour = Gießen
pray = beten
pretend = vorgeben
pride = stolz
priest = Priester
prize = Preis
probable = wahrscheinlich
promise = Versprechen
propose = vorschlagen
punch = punch
quit = beenden
remark = Bemerkung
remind = erinnern
reply = Antworten
reputation = Ruf
resist = widerstehen
resort = resort
ring = ring
rip = rip
roof = Dach
rope = Seil
rub = rub
sail = Segeln
scheme = Schema
script = Skript
shall = ist
shirt = shirt
silly = dumm
sir = sir
slight = leichte
smart = smart
smile = lächeln
sock = Socke
spell = Zauber
station = station
stretch = stretch
stupid = dumm
submit = senden
substantial = erhebliche
suppose = angenommen
surgery = Chirurgie
suspicious = verdächtige
sympathy = Sympathie
tale = Geschichte
tall = hoch
tear = reißen
temporary = temporäre
throat = Kehle
tiny = kleine
toe = Zeh
tomorrow = morgen
tower = tower
translate = übersetzen
truck = LKW
uncle = Onkel
wake = wake
witness = Zeuge
wrap = wrap
yesterday = gestern
youth = Jugend
appoint = bestellen
clothe = kleiden
complicate = erschweren
confer = verleihen
converse = converse
depress = drücken
disappoint = enttäuschen
elect = wählen
equip = Ausrüstung
ignorant = unwissend
inflate = aufblasen
instruct = weisen
oblige = verpflichten
politic = Politik
pollute = verschmutzen
refrigerate = Kühlschrank
reside = wohnen
situate = verorten
unite = vereinen
